R 1920 1080
NO ./xpms/wood.xpm
SO ./xpms/greystone.xpm
WE ./xpms/mossy.xpm
EA ./xpms/eagle.xpm
S ./xpms/barrel.xpm


F 192,200,255

C 255,218,185

        1111111111111111111111111
        1000000000110000000000001
        1011000001110000002000001
        1001000000E00002000000001
111111111011000001110000000000001
100000000011000001110111110111111
11110111111111011100000010001
11110111111111011101010010001
11000000110101011100000010001
10000200000000001100000010001
10000000000000001101010010001
1100000111010101111101111000111
11110111 1110101 110111101001
11111111 1111111 111111111111